00 00 00 15 16 15 16 15 16 15 15 15 16 00 00 00 00 02 01 03 00 16 15 16 15 16 15 16 15 16 15 15 15 16 00 00 00 00 00 00
00 15 00 00 00 00 00 00 00 00 00 00 00 00 00 00 00 16 02 01 03 00 00 00 00 00 00 16 15 16 15 16 15 16 15 16 15 15 15 16
00 00 16 15 15 16 15 16 15 16 15 15 15 16 00 00 00 00 00 00 00 02 01 03 00 16 15 00 00 00 16 15 16 15 16 15 16 15 16 15 
00 00 15 00 00 00 00 00 00 00 00 00 00 00 00 00 00 16 02 01 03 00 16 00 00 16 00 00 00 00 00 00 00 00 00 00 00 00 00 00
16 15 16 15 16 15 15 15 16 00 00 00 00 00 00 00 00 00 02 01 03 00 00 15 15 00 00 00 00 00 00 00 00 00 00 17 00 00 00 00
00 00 16 15 16 15 16 15 15 15 16 00 00 00 00 00 00 15 02 01 03 00 16 00 16 00 00 00 00 00 17 00 00 00 15 19 16 00 00 00
00 00 00 00 00 00 00 00 00 00 00 00 00 00 00 00 00 00 02 01 03 00 16 00 00 16 00 00 00 16 00 17 15 00 16 00 16 15 15 00
00 00 00 17 17 17 17 17 17 17 17 00 00 00 00 00 15 00 02 01 03 00 00 00 00 00 00 00 16 17 00 00 16 16 15 00 15 16 00 00
00 00 00 17 00 00 19 00 00 00 17 00 00 00 00 16 15 00 02 01 03 00 15 00 00 00 00 16 17 00 15 00 17 17 16 00 16 00 00 15
00 00 00 17 00 00 00 00 00 00 17 00 00 00 15 00 16 00 02 01 03 00 16 00 00 00 00 17 00 00 00 00 17 00 16 00 16 00 15 00
00 00 00 17 00 00 15 00 00 00 17 00 00 15 00 00 00 17 02 01 03 16 00 00 00 00 00 17 00 17 17 17 17 00 17 00 17 17 16 00 
00 00 00 17 00 00 16 00 00 00 17 00 00 00 00 00 00 16 02 01 03 00 00 00 00 00 00 17 00 17 00 00 00 00 00 00 17 17 16 00
00 00 00 17 00 00 00 00 00 00 17 00 00 16 00 00 00 15 02 01 03 00 00 16 00 00 00 17 00 17 00 17 17 17 17 00 17 17 16 00
00 00 00 16 17 17 18 17 17 17 17 00 00 00 00 16 00 15 02 01 03 00 00 00 00 00 15 02 00 00 00 00 00 00 17 00 17 17 16 00
00 00 00 15 15 16 00 00 00 00 00 00 00 00 00 00 00 00 02 01 03 00 15 15 00 00 00 17 00 17 17 17 17 00 17 00 17 17 16 00
00 00 00 00 16 00 00 00 00 00 00 00 16 15 00 16 00 16 02 01 03 00 00 00 00 00 00 17 00 00 00 00 16 00 15 00 00 00 00 00
00 00 00 16 00 00 00 00 00 00 00 00 16 16 00 00 00 00 02 01 03 00 00 15 00 00 16 17 00 16 00 15 00 00 16 16 00 00 16 16
00 00 00 16 00 00 00 00 00 00 00 00 00 00 00 15 00 11 06 01 07 12 00 00 00 00 00 16 16 00 15 00 16 00 00 00 15 16 15 16
04 04 04 04 04 04 04 04 04 04 04 04 04 04 04 04 04 06 01 01 01 07 04 04 04 04 04 04 04 04 04 04 04 04 04 04 04 04 04 04
01 01 01 01 01 01 01 01 01 01 01 01 01 01 01 01 01 01 01 00 01 01 01 01 01 01 01 01 01 01 01 01 01 01 01 01 01 01 01 01
05 05 05 05 05 05 05 05 05 05 05 05 05 05 05 05 05 09 01 01 01 08 05 05 05 05 05 05 05 05 05 05 05 05 05 05 05 05 05 05
00 00 00 00 00 00 00 00 00 00 00 00 00 00 00 00 00 14 09 01 08 13 00 00 00 00 00 00 00 00 00 00 00 00 00 00 00 00 00 00
15 15 15 15 15 15 15 15 15 15 15 15 15 15 15 15 15 15 02 01 03 15 15 15 15 15 15 15 15 15 15 15 15 15 15 15 15 15 15 15
15 15 15 15 15 15 15 15 15 15 15 15 15 15 15 15 15 15 02 01 03 15 15 15 15 15 15 15 15 15 15 15 15 15 15 15 15 15 15 15
15 15 15 15 15 15 15 15 15 15 15 15 15 15 15 15 15 15 02 01 03 15 15 15 15 15 15 15 15 15 15 15 15 15 15 15 15 15 15 15
15 15 15 15 15 15 15 15 15 15 15 15 15 15 15 15 15 15 02 01 03 15 15 15 15 15 15 15 15 15 15 15 15 15 15 15 15 15 15 15
15 15 15 15 15 15 15 15 15 15 15 15 15 15 15 15 15 15 02 01 03 15 15 15 15 15 15 15 15 15 15 15 15 15 15 15 15 15 15 15
00 00 00 00 00 00 00 00 00 00 00 00 00 00 00 00 00 00 02 01 03 00 00 00 00 00 00 00 00 00 00 00 00 00 00 00 00 00 00 00
00 00 00 00 00 00 00 00 00 00 00 00 00 00 00 00 00 00 02 01 03 00 00 00 00 00 00 00 00 00 00 00 00 00 00 00 00 00 00 00
00 00 00 00 00 00 00 00 00 00 00 00 00 00 00 00 00 00 02 01 03 00 00 00 00 00 00 00 00 00 00 00 00 00 00 00 00 00 00 00
00 00 00 00 00 00 00 00 00 00 00 00 00 00 00 00 00 00 02 01 03 00 00 00 00 00 00 00 00 00 00 00 00 00 00 00 00 00 00 00
15 15 15 15 15 15 15 15 15 15 15 15 15 15 15 15 15 15 02 01 03 15 15 15 15 15 15 15 15 15 15 15 15 15 15 15 15 15 15 15
15 15 15 15 15 15 15 15 15 15 15 15 15 15 15 15 15 15 02 01 03 15 15 15 15 15 15 15 15 15 15 15 15 15 15 15 15 15 15 15
00 00 00 00 00 00 00 00 00 00 00 00 00 00 00 00 00 00 02 01 03 00 00 00 00 00 00 00 00 00 00 00 00 00 00 00 00 00 00 00
00 00 00 00 00 00 00 00 00 00 00 00 00 00 00 00 00 00 02 01 03 00 00 00 00 00 00 00 00 00 00 00 00 00 00 00 00 00 00 00
00 00 00 00 00 00 00 00 00 00 00 00 00 00 00 00 00 00 02 01 03 00 00 00 00 00 00 00 00 00 00 00 00 00 00 00 00 00 00 00
15 15 15 15 15 15 15 15 15 15 15 15 15 15 15 15 15 15 02 01 03 15 15 15 15 15 15 15 15 15 15 15 15 15 15 15 15 15 15 15
15 15 15 15 15 15 15 15 15 15 15 15 15 15 15 15 15 15 02 01 03 15 15 15 15 15 15 15 15 15 15 15 15 15 15 15 15 15 15 15
15 15 15 15 15 15 15 15 15 15 15 15 15 15 15 15 15 15 02 01 03 15 15 15 15 15 15 15 15 15 15 15 15 15 15 15 15 15 15 15
15 15 15 15 15 15 15 15 15 15 15 15 15 15 15 15 15 15 02 01 03 15 15 15 15 15 15 15 15 15 15 15 15 15 15 15 15 15 15 15